#######***##########
#&..#..............!
#.###.###.*###...###
#.....#.....#.#....#
#####.#.###@#.#.##.#
#.#.........#.#.#..#
#.#**..*#.##..#.#.##
#...#.#.#.#..##.#...
#..#..#.###..#....##
........##..#.#.##.!
###*##.....####..&..
