...*****.........
.................
......##.....*...
..&.......@......
.................
.....##.#######..
....*............
!!!!!!!!!**!!!!!!