.................
.................
......##.........
..&.......@......
.................
.....##.#######..
.................
!!!!!!!!!!!!!!!!!