................
.............&...
......##.........
..&.......@......
.................
.....##.#######..
.................
!!!!!!!!!!!!!!!!!