##################################################
#....................#...........................#
#.#############.#####.#.#####.####...#########.#.
#............@.#...#.#.#...#.#...#............#
#.#######.#####.#.#.#.#.#.#.#.#####.#########.#
#................#.#.#.#.#.#.................#
#.######..&#####.#.#.#.#.#.####....####.#####.#
#................#.#..#.#.#...................#
#.############.##.#..#.#.#.&##################.#
#...............#.#.#.#.#.#..................#.#
#.######.######.#.........########.############.#
#.............#...#...##.....####...............
############################........##############!