##################################################
#....................#...........................#
#.#############.#####.#.#####.####.*..#########.#
#............@.#...#.#.#...#.#...#............#
#.#######.#####.#.#.#.#.#.#.#.#####.#########.#
#................#.#.#.#.#.#.................#
#.######..&#####.#.#.#.#.#.####....####.#####.#
#................#.#..#.#.#...................#
#.############.##.#..#.#.#.&##################.#
#...............#.#.#.#.#.#..................#.#
#.######.######.#.........########.############.#
#.............#...#...##....*.####...............
############################........##############!