##################################################
#....................#...........................#
#.#############.#####.#.#####.####....#########.#
#............@.#...#.#.#...#.#...#............#
#.#######.#####.#.#.#.#.#.#.#.#####.#########.#
#................#.#.#.#.#.#.................#
#.######..&#####.#.#.#.#.#.####....####.#####.#
#................#.#..#.#.#...................#
#.############.##.#..#.#.#.&##################.#
#...............#.#.#.#.#.#..................#.#
#.######.######.#.........########.############.#
#.............#...#...##......####...............
############################........##############!