##################################################
#....................#...........................#
#.#############.#####.#.#####.#################.#
#.&...........@.#...#.#.#...#.#...#............#
#.#############.#.#.#.#.#.#.#.#####.#########.#
#...............#.#.#.#.#.#.#.................#
#.###############.#.#.#.#.#.###################.#
#................#.#.#.#.#.#...................#
#.###############.#.#.#.#.#.###################.#
#...............#.#.#.#.#.#.................@.#.#
#.#############.#.#.#.#.#.#.#####################.#
#.............#...#...#...#.......................#
##################################################!