##################################################
#....................#...........................#
#.#############.#####.#.#####.####....#########.#
#............@.#...#.#.#...#.#...#............#
#.#######.#####.#.#.#.#.#.#.#.#####.#########.#
#................#.#.#.#.#.#.................#
#.######..######.#.#.#.#.#.####....####.#####.#
#................#.#..#.#.#...................#
#.############.##.#..#.#.#.###################.#
#...............#.#.#.#.#.#..................#.#
#.######.######.#.........########.############.#
#.............#...#...##......####...............
############################........##############!