................#
................#
......##........#
..&.......@.....#
................#
................#
................#
#################