##################################################
#....................#...........................#
#.#############.#####.#.#####.####...#########.#.
#............@.....#.#.#...#.#...#............#
#.#######.#####.#.#.#.#.#.#.#.#####.#########.#
#................#.#.#.#.#.#.................#
#.######..&#####.#.#.#.#.#.####..*.####.#####.#
#................#.#..#.#.#...................#
#.############.##.#..#.#.#.&##################.#
#...*...........#.#.#.#.#.#..................#.
#.######.######.#.........########.############.#
#.............#...#...##.....####...............
############################........##############!