##################################################
#....................#...........................#
#.#############.#####.#.#####.####....#########.#
#............@.#...#.#.#...#.#...#............#
#.#######.#####.#.#.#.#.#.#.#.#####.#########.#
#................#.#.#.#.#.#.................#
#.######..######.#.#.#.#.#.####....####.#####.#
#................#.#..#.#.#...................#
#.############.##.#..#.#.#.###################.#
#...............#.#.#.#.#.#..................#.#
#.######.######.#...#.#.#.########.############.#
#.............#...#...#...#.......................
##################################################!