#######***##########
#&..#.......#..#...!
#.###.###.*###.#.###
#.....#.....#.#....#
#####.#.###@#.#.##.#
#.#.........#.#.#..#
#.#**..*#.##..#.#.##
#...#.#.#.#..##.#...
#..#..#.###..#....##
........##..#.#.##..
###*##.....####..&..