&...#..#.....
.#.#..#..##.#
.#.#*##.###.!
.#......#.#..
.#..#.....##.
.#.########..
...***#......
.#######.####
.....*.#*#...
#..#.#....#..
.@##.#...####
#..#.#.##.##.
...#.#!#..**.
